screens/castle/tiles.png
14 20
4 5 5 5 5 5 5 5 5 5 5 5 5 5 5 5 5 5 6 0 
1 2 2 2 2 2 2 2 2 2 2 2 2 2 2 2 2 10 6 2 
0 18 0 0 18 0 0 18 0 0 0 0 0 0 0 0 0 1 6 0 
0 17 0 0 17 0 0 17 0 0 0 0 0 0 0 0 0 0 14 0 
0 17 0 20 17 0 0 17 0 0 0 0 0 20 0 0 0 0 0 0 
0 17 0 19 17 0 0 17 0 0 0 0 0 19 0 0 0 0 0 0 
0 17 0 0 17 0 0 17 0 0 0 0 0 0 0 0 0 7 9 0 
0 17 0 0 17 0 0 17 0 0 0 0 0 0 0 0 0 4 6 0 
0 16 0 0 16 0 0 16 0 0 0 0 0 0 0 0 0 4 6 0 
0 0 0 0 0 0 0 0 0 0 0 0 0 0 0 0 0 0 0 0 
0 0 0 0 0 0 0 0 0 0 0 0 0 0 0 0 0 0 0 0 
0 0 0 0 0 0 0 0 0 0 0 0 0 0 0 0 0 0 0 0 
0 0 0 0 0 0 0 0 0 0 0 0 0 0 0 0 0 0 0 0 
0 0 0 0 0 0 0 0 0 0 0 0 0 0 0 0 0 0 0 0 